phil		philosophy
phil		philosophical
anthrplgy	anthropology
ntnlsm		nationalism
ntnl		national
anrchsm		anarchism
anrch		anarcho
anrch		anarcha
chr		christian
rcnstrctnsm	reconstructionism
util		utilitarian
prmtvsm		primitivism
sndclsm		syndicalism
cptlsm		capitalism
rlsm		realism
mncplsm		municipalism
envrnmntl	environmental
lbrtrnsm	libertarianism
librtn		libertarian
rlgs		religious
rlgn		religion
lang		language
neuro		neuroscience
mdrn		modern
pstmdrn		postmodern
islmc		islamic
sci		science
scntfc		scientific
dlctcl		dialectical
mtrlsm		materialism
marx		marxist
lenin		leninist
mao		maoist
ntrl		natural
math		mathematics
edu		education
cntl		continental
rltvsm		relativism
expnsnst	expansionist
lib		liberal
intrntnlsm	internationalism
cnsrvtsm	conservatism
cnsrvtv		conservative
cltrl		cultural
ptrnlsm		paternalism
ptrnl		paternal
phnmnl		phenomenal
fmnsm		feminism
sprtst		separatist
imp		imperialism
conf		confirmation
repub		repubicanism
sclsm		socialism
demo		democratic
dmcrcy		democracy
inclsv		inclusive
authrtrnsm	authoritarianism
authrtrn	authoritarian
revltnry	revolutionary
mvmnt		movement
skptcsm		skepticism
objctv		objective
sbjctv		subjective
trscdntl	transcendental
trscdntlsm	transcendentalism
idlsm		idealism
rdctnsm		reductionism
kshmr		kashmir
psptsm		perspectivism
pplsm		populism
insrctn		insurrectionary
indvdl		individualist
lft		left-wing
mkt		market
synthst		synthesist
clctvst		collectivist
no-adj		no adjective
cnfcnsm		confucianism
anmls		anomalous
pythgrnsm	pythagoreanism
rdctv		reductive
hstrcl		historical
consqntlsm	consequentialism
cnstvst		constructivist
epstmly		epistemology
illum of than	illuminates of thanateros
cmnsm		communism
instrmtl	instrumental
rtnlty		rationality
pst-lft		post-left
ord aurum sols	ordo aurum solis
recnstrctvsm	reconstructivism
rsn		reason
rsng		reasoning
prac		practical
histl		historical
dtrmnsm		determinism
ldrls		leaderless
rstnc		resistance
mystcsm		mysticism
poli		politcal
cath		catholicism
seclr		secular
librtan		liberation
thlgy		theology
thlgcl 		Theological
cgntvsm		cognitivism
ncgntvsm	noncognitivism
unvrslsm	universalism
rprsnttnlsm	representationalism
strctrlsm	structuralism
1st stnic chrch	first statanic church
rvsnst		revisionist
cntrsm		centrism
intlctlsm	intellectualism
hmnstc		humanistic
ntrlsm		naturalism
brht		bright
grn		green
envrnmntlsm	environmentalism
evmtsm		environmentalism
tsphy		theosophy
dlsm		dualism
dual		dualistic
shmnsm		shamanism
econ		economics
crit		criticism
crit		critique
crit		critical
dscrmntn	discrimination
premlnlsm	premillennialism
corp		corporate
untrn		unitarian
mtphscs		metaphysics
mtphscl		metaphysical
asctv		associative
rvsnsm		revisionism
intgrlsm	integralism
por		portuguese
psych		psychological
rtnlsm		rationalism
necessitarism	necessitarianism
soc		social
machiavellism	machiavellianism
communitarism	communitarianism
epiphenomenaly	epiphenomenalism
fdmtlsm		fundamentalism
pstvsm		positivism
neo-arsttlnsm	neo-aristotelianism
tht		thought
hegel		hegelian
cat		categorical
frat		fraternitas
cnfdrlsm	confederalism
heterophenomism	heterophenomenology
thstc		theistic
exstntlsm	existentialism
rnsnc		renaissance
opn-src		open-source
absltsm		absolutism
